-- PAGE and ACCESS_ROLES in DIBOTS

Price - MARKP, MARKP_LIMITED
FundFlow - FUNDFLOW, FUNDFLOW_LIMITED
Momentum - MOMENTUM, MOMENTUM_LIMITED
Insider Move - INSIDER, INSIDER_LIMITED
ShareBB - SHAREBB, SHAREBB_LIMITED
Dealing - DEAL, DEAL_LIMITED
IR - IR with extension
Broker Trades - INVESTOR with extension
Retail - RETAIL_LIMITED
Foreign - FOREIGN_LIMITED
ROD - ROD_VIEW with extension
Fundamental - FUNDA, FUNDA_LIMITED
Peer - PEER, PEER_LIMITED
EE - ESTIMATE_EARNING
People - PEOP, PEOP_LIMITED
Shareholder - SHAREH, SHAREH_LIMITED
Subsidiary - SUBSI, SUBSI_LIMITED
Affiliated - AFFIL, AFFIL_LIMITED
News - NEWS, NEWS_LIMITED
Research - REP_REPO, REP_REPO_LIMITED
Financial - REP_REPO, REP_REPO_LIMITED

Portfolio - PORTFOLIO
BursaMarket - B_MARKP
BrokerDashboard - B_DASHBRD
MarketStats - B_MARKETSTATS
HotStocks - B_STOCK
Retail - B_RETAIL
Foreign - B_FOREIGN
ValueGrowth - VALUE_STOCK